une affiche: a poster
une chaise: a chair
une chambre: a bedroom
un chandail: a sweater
un coin: a corner
une commode: a dresser
une communauté: a community
un coussin: a cushion
un couvre-lit: a comforter
une couverture: a blanket
une lampe: a lamp
un lit: a bed
les meubles: the furniture
un miroir: a mirror
un pantalon: pants
un placard: a cupboard
une porte: a door
un quartier: a neighbourhood
une résidence: a residence
des rideaux: curtains
des stores: blinds
une tablette: a tablet
un tapis: a rug
une télévision: a television
un oreiller: a pillow
une étagère: a shelf
un fauteuil: an armchair
une fenêtre: a window
un tiroir: a drawer
les vêtements: clothing
à côté de: beside
à droite de: to the right of
à gauche de: to the left of
au-dessus de: above
au-dessous de: below
dans: in
derrière: behind
devant: in front of
en face de: across from
entre: between
loin de: far from
près de: close to
sous: under
sur: on


---

adolescent(e): adolescent
amusant(e): funny
anglais(e): english
asiatique: asian
autochtone: indigenous
autre: other
aventureux/euse: adventurous
beau/bel/belle: beautiful
bon(ne): good
canadien(ne): canadian
chaque: every
créatif/ive: creative
culturel(le): cultural
différent(e): different
extroverti(e): outgoing
français(e): french
gentil(le): kind
grand(e): large/tall/great
impressionné(e): impressed
indépendant(e): independent
intelligent(e): intelligent
italien(ne): italien
jeune: young
libanais(e): lebanese
meilleur(e): better
nouveau/nouvel/nouvelle: new
parascolaire: extracurricular
passé(e): last
portugais(e): portuguese
préféré(e): favourite
prochain(e): next
respectueux/euse: respectful
responsable: responsible
sportif/ive: athletic
sympa: nice
unique: unique


---
l'ail: garlic
un aliment: food
le beurre: butter
le bifteck: steak
le bœuf: beef
une boisson (gazeuse): a drink (pop)
le café (glace): (iced) coffee
une carotte: a carrot
des céréales: cereal
les cerises: cherries
le chocolat: chocolate
le chou: cabbage
un citron: a lemon
une collation: a snack
la confiture: jam
un cornichon: a pickle
la crème: cream
une crêpe: a crepe
des crevettes: shrimp
un croissant: a croissant
le jambon: ham
le jus: juice
le lait: milk
la laitue: lettuce
un légume: a vegetable
la limonade: lemonade
la malbouffe: junk food
un mets: a dish
les moules: mussels
un œuf: an egg
un oignon: an onion 
les olives: olives
un orange: an orange
les pâtes: pasta
le plat (principal): (main) dish
une poire: a pear
un poisson: a fish
le poivre: pepper
une pomme de terre: a 


---
des croustilles: chips
le (petit) déjeuner: breakfast/lunch
un dessert: a dessert
le dîner: lunch/diner
l'eau: water
une entrée: an appetizer
une épice: a spice
des épinards: spinach
le poulet: chicken
la poutine: poutine
un repas: a meal
le riz: rice
le rosbif: roastbeef
la salade: salad
la sauce: sauce
une saucisse: a sausage
le saumon (fume): (smoked) salmon
la farine: flour
des fraises: strawberries
des friandises: treats
les frites: fries
le fromage: cheese
les fruits de mer: seafood
un gâteau: a cake
le homard: lobster
un hors d'œuvre: appetizer
l'huile: oil
un ingrédient: an ingredient
le sel: salt
le sorbet: sorbet
un sous-marin: a sub sandwich
le sucre: sugar
une tarte: a pie
le thé (glace): (ice) tea
le thon: tuna
une tomate: a tomato
la viande: meat
le yogourt: yogourt

---
(rec) les ancêtres: ancestors
un animal de compagnie: a pet
(rec) un animal en peluche: a stuffed animal
(rec) un arbre: a tree
(rec) l'avenir: the future
une balançoire: a swing
un blogue: a blog
la bouffe: food
(rec) une bougie: a candle
un cadeau: a present
une carte: a card
un casse-tête: a puzzle
le centre-ville: downtown
(rec) un cerf-volant: a kite
(rec) le cœur: the heart
une collation: a snack
(rec) la communauté: the community
(rec) un concours: a competition
un copain: a friend
un courriel: an email
(rec) un coutume: a custom
(rec) un défilé: a parade
un dessin: a drawing
(rec) un dessin animé: a cartoon
le directeur: the principal
une émission: a show
un enseignant: a teacher
l'enfance: childhood
un événement: an event
une fleur: a flower
un gardien d'enfant: a babysitter
une glissoire: a slide